空空空空空空空空空空空空空
空空空空空空空空空空空空空
空空空空空空空空空空空空空
空空空空空空空空空空空空空
空空铁铁铁铁空空水水水空空
空空空空空空空空空空空空空
空空空空空空空空空空空空空
空空铁铁铁铁铁铁铁铁铁空空
空空空空空空空空空空空空空
空空砖砖砖砖砖砖砖砖砖空空
空空空空空空空空空空空空空
空空空空空空空空空空空空空
空空空副空空空空空主空空空