敌草草草草草敌草草草草草敌草
草草空铁砖铁空铁砖铁空草草草
草草空砖空砖空砖空砖空草草草
草草空铁砖铁空铁空铁空草草草
草草空空空砖空砖空砖空草草草
草草空铁砖铁空铁砖铁空草草草
敌草草草草水水水草草草草敌草
铁空空铁空空铁空空铁空空铁草
草空空空空砖砖砖空空空空草草
草砖铁砖铁水水水铁砖铁砖草草
草砖空砖空空空空空砖空砖草草
草砖空砖空砖砖砖空砖空砖草草
草草草空空砖堡砖空主草草空草
草草草空空砖堡砖空主草草空草